"filename", "language", "Python", "pip requirements", "comment", "blank", "total"
"d:\school\automl\automl\server\__init__.py", "Python", 10, 0, 3, 1, 14
"d:\school\automl\automl\server\cmd.py", "Python", 43, 0, 1, 17, 61
"d:\school\automl\automl\server\early_stop\basic_early_stop.py", "Python", 14, 0, 8, 4, 26
"d:\school\automl\automl\server\early_stop\curve_functions.py", "Python", 75, 0, 176, 30, 281
"d:\school\automl\automl\server\early_stop\curve_model.py", "Python", 153, 0, 168, 16, 337
"d:\school\automl\automl\server\early_stop\curve_stop.py", "Python", 26, 0, 0, 13, 39
"d:\school\automl\automl\server\early_stop\median_stop.py", "Python", 20, 0, 0, 10, 30
"d:\school\automl\automl\server\feature_select\__init__.py", "Python", 1, 0, 0, 0, 1
"d:\school\automl\automl\server\feature_select\basic_select.py", "Python", 19, 0, 16, 4, 39
"d:\school\automl\automl\server\feature_select\constants.py", "Python", 53, 0, 27, 21, 101
"d:\school\automl\automl\server\feature_select\fginitialize.py", "Python", 381, 0, 131, 112, 624
"d:\school\automl\automl\server\feature_select\fgtrain.py", "Python", 154, 0, 32, 43, 229
"d:\school\automl\automl\server\feature_select\gbdtselector.py", "Python", 53, 0, 53, 17, 123
"d:\school\automl\automl\server\feature_select\gradient_selector.py", "Python", 346, 0, 238, 48, 632
"d:\school\automl\automl\server\feature_select\learnability.py", "Python", 304, 0, 152, 74, 530
"d:\school\automl\automl\server\feature_select\requirements.txt", "pip requirements", 0, 4, 0, 1, 5
"d:\school\automl\automl\server\feature_select\syssettings.py", "Python", 4, 0, 21, 5, 30
"d:\school\automl\automl\server\feature_select\utils.py", "Python", 41, 0, 22, 16, 79
"d:\school\automl\automl\server\http_handler.py", "Python", 38, 0, 1, 6, 45
"d:\school\automl\automl\server\model\globals.py", "Python", 13, 0, 0, 4, 17
"d:\school\automl\automl\server\model\study.py", "Python", 90, 0, 2, 18, 110
"d:\school\automl\automl\server\model\trials.py", "Python", 50, 0, 1, 8, 59
"d:\school\automl\automl\server\model\worker.py", "Python", 86, 0, 0, 27, 113
"d:\school\automl\automl\server\search\__init__.py", "Python", 9, 0, 0, 0, 9
"d:\school\automl\automl\server\search\base_chocolate_algorithm.py", "Python", 71, 0, 15, 28, 114
"d:\school\automl\automl\server\search\base_hyperopt_algorithm.py", "Python", 137, 0, 27, 52, 216
"d:\school\automl\automl\server\search\basic_search.py", "Python", 42, 0, 0, 7, 49
"d:\school\automl\automl\server\search\bayesian_optimization.py", "Python", 123, 0, 25, 45, 193
"d:\school\automl\automl\server\search\cmaes.py", "Python", 12, 0, 3, 3, 18
"d:\school\automl\automl\server\search\grid_search.py", "Python", 42, 0, 5, 25, 72
"d:\school\automl\automl\server\search\mocmaes.py", "Python", 12, 0, 3, 4, 19
"d:\school\automl\automl\server\search\random_fuction.py", "Python", 29, 0, 39, 8, 76
"d:\school\automl\automl\server\search\random_search.py", "Python", 42, 0, 4, 14, 60
"d:\school\automl\automl\server\search\simulate_anneal.py", "Python", 12, 0, 3, 4, 19
"d:\school\automl\automl\server\search\static.py", "Python", 29, 0, 39, 8, 76
"d:\school\automl\automl\server\search\tpe.py", "Python", 12, 0, 3, 4, 19
"d:\school\automl\automl\server\setup.py", "Python", 30, 0, 0, 3, 33
"d:\school\automl\automl\server\testtools\test_search\test_basic_search.py", "Python", 14, 0, 0, 4, 18
"d:\school\automl\automl\server\testtools\test_search\test_bayes_optimization.py", "Python", 58, 0, 0, 7, 65
"d:\school\automl\automl\server\testtools\test_search\test_grid_search.py", "Python", 51, 0, 0, 6, 57
"d:\school\automl\automl\server\testtools\test_search\test_mocmaes.py", "Python", 58, 0, 0, 6, 64
"d:\school\automl\automl\server\testtools\test_search\test_random_search.py", "Python", 58, 0, 0, 7, 65
"d:\school\automl\automl\server\testtools\test_search\test_simulate_anneal.py", "Python", 58, 0, 0, 6, 64
"d:\school\automl\automl\server\testtools\test_search\test_tpe.py", "Python", 58, 0, 0, 6, 64
"d:\school\automl\automl\server\version.py", "Python", 9, 0, 0, 1, 10
"Total", "-", 2940, 4, 1218, 743, 4905